"filename", "language", "CSS", "JavaScript", "JSON", "comment", "blank", "total"
"/Users/duc/Dropbox/Projects/Web/cryo-web-monitor/src/client/App.js", "JavaScript", 0, 64, 0, 3, 5, 72
"/Users/duc/Dropbox/Projects/Web/cryo-web-monitor/src/client/content/images/ImageContainer.js", "JavaScript", 0, 29, 0, 1, 3, 33
"/Users/duc/Dropbox/Projects/Web/cryo-web-monitor/src/client/content/plotMain/PlotMain.js", "JavaScript", 0, 151, 0, 3, 16, 170
"/Users/duc/Dropbox/Projects/Web/cryo-web-monitor/src/client/content/plotsMini/PlotsFullscreen.js", "JavaScript", 0, 79, 0, 0, 7, 86
"/Users/duc/Dropbox/Projects/Web/cryo-web-monitor/src/client/content/plotsMini/PlotsMini.js", "JavaScript", 0, 201, 0, 1, 21, 223
"/Users/duc/Dropbox/Projects/Web/cryo-web-monitor/src/client/content/status/Status.js", "JavaScript", 0, 95, 0, 0, 7, 102
"/Users/duc/Dropbox/Projects/Web/cryo-web-monitor/src/client/content/table/Table.js", "JavaScript", 0, 148, 0, 0, 16, 164
"/Users/duc/Dropbox/Projects/Web/cryo-web-monitor/src/client/content/table/TableContainer.js", "JavaScript", 0, 32, 0, 2, 4, 38
"/Users/duc/Dropbox/Projects/Web/cryo-web-monitor/src/client/content/table/TableExport.js", "JavaScript", 0, 25, 0, 0, 3, 28
"/Users/duc/Dropbox/Projects/Web/cryo-web-monitor/src/client/content/table/TableHeader.js", "JavaScript", 0, 90, 0, 0, 5, 95
"/Users/duc/Dropbox/Projects/Web/cryo-web-monitor/src/client/content/table/TableRowSingle.js", "JavaScript", 0, 92, 0, 2, 9, 103
"/Users/duc/Dropbox/Projects/Web/cryo-web-monitor/src/client/content/table/TableToolbar.js", "JavaScript", 0, 78, 0, 1, 4, 83
"/Users/duc/Dropbox/Projects/Web/cryo-web-monitor/src/client/global/Data.js", "JavaScript", 0, 61, 0, 6, 10, 77
"/Users/duc/Dropbox/Projects/Web/cryo-web-monitor/src/client/global/Theme.js", "JavaScript", 0, 60, 0, 0, 8, 68
"/Users/duc/Dropbox/Projects/Web/cryo-web-monitor/src/client/site/API.js", "JavaScript", 0, 87, 0, 1, 9, 97
"/Users/duc/Dropbox/Projects/Web/cryo-web-monitor/src/client/site/Footer.js", "JavaScript", 0, 25, 0, 0, 2, 27
"/Users/duc/Dropbox/Projects/Web/cryo-web-monitor/src/client/site/Header.js", "JavaScript", 0, 178, 0, 7, 16, 201
"/Users/duc/Dropbox/Projects/Web/cryo-web-monitor/src/client/site/sidebar/Filter.js", "JavaScript", 0, 112, 0, 0, 5, 117
"/Users/duc/Dropbox/Projects/Web/cryo-web-monitor/src/client/site/sidebar/Navigation.js", "JavaScript", 0, 76, 0, 0, 4, 80
"/Users/duc/Dropbox/Projects/Web/cryo-web-monitor/src/client/site/sidebar/Sidebar.js", "JavaScript", 0, 99, 0, 2, 9, 110
"/Users/duc/Dropbox/Projects/Web/cryo-web-monitor/src/client/site/sidebar/Updates.js", "JavaScript", 0, 75, 0, 0, 5, 80
"/Users/duc/Dropbox/Projects/Web/cryo-web-monitor/src/client/utils/ContentContainer.js", "JavaScript", 0, 74, 0, 2, 3, 79
"/Users/duc/Dropbox/Projects/Web/cryo-web-monitor/src/client/utils/FormatDate.js", "JavaScript", 0, 17, 0, 0, 4, 21
"/Users/duc/Dropbox/Projects/Web/cryo-web-monitor/src/client/utils/ImageDisplay.js", "JavaScript", 0, 111, 0, 1, 9, 121
"/Users/duc/Dropbox/Projects/Web/cryo-web-monitor/src/client/utils/ImageFullscreen.js", "JavaScript", 0, 274, 0, 0, 25, 299
"/Users/duc/Dropbox/Projects/Web/cryo-web-monitor/src/client/utils/PullAndRefresh.js", "JavaScript", 0, 32, 0, 0, 3, 35
"/Users/duc/Dropbox/Projects/Web/cryo-web-monitor/src/client/utils/ScrollToTop.js", "JavaScript", 0, 39, 0, 0, 7, 46
"/Users/duc/Dropbox/Projects/Web/cryo-web-monitor/src/client/utils/SmallDivider.js", "JavaScript", 0, 17, 0, 0, 3, 20
"/Users/duc/Dropbox/Projects/Web/cryo-web-monitor/src/config.json", "JSON", 0, 0, 134, 0, 7, 141
"/Users/duc/Dropbox/Projects/Web/cryo-web-monitor/src/index.css", "CSS", 12, 0, 0, 0, 1, 13
"/Users/duc/Dropbox/Projects/Web/cryo-web-monitor/src/index.js", "JavaScript", 0, 11, 0, 0, 6, 17
"/Users/duc/Dropbox/Projects/Web/cryo-web-monitor/src/server/AutoDelete.js", "JavaScript", 0, 7, 0, 0, 9, 16
"/Users/duc/Dropbox/Projects/Web/cryo-web-monitor/src/server/FileWatcher.js", "JavaScript", 0, 97, 0, 1, 13, 111
"/Users/duc/Dropbox/Projects/Web/cryo-web-monitor/src/server/Logger.js", "JavaScript", 0, 55, 0, 1, 6, 62
"/Users/duc/Dropbox/Projects/Web/cryo-web-monitor/src/server/Memory.js", "JavaScript", 0, 104, 0, 3, 17, 124
"/Users/duc/Dropbox/Projects/Web/cryo-web-monitor/src/server/Reader.js", "JavaScript", 0, 37, 0, 10, 9, 56
"Total", "-", 12, 2732, 134, 47, 290, 3215